1111111111111111111111111111111111
1000000C000000000000000000000C0001
11100101001000C01010010000C0010101
1010010010101010001001000E00010101
1P0001000000C0000000000C0000000001
1111111111111111111111111111111111
