111111111111111111111111111111111
10000000000000C00000C000000000001
111001010010000010100100000001001
1010010010101010001001000E0001001
1P0001000C00C000000000000000000C1
111111111111111111111111111111111
