1111111111111111111111111111111111
1P0000000000000C00000C0000000010E1
1111111111111111111111111111111111
